"a" = (/obj/structure/displaycase{icon_state = "hub"},/turf/simulated/floor/bluegrid,/area/space)
"b" = (/turf/unsimulated/mineral,/area/space)
"c" = (/turf/simulated/wall,/area/space)
"d" = (/turf/simulated/floor/tiled/freezer,/area/space)
"e" = (/turf/simulated/shuttle/wall,/area/space)
"f" = (/turf/simulated/floor/tiled/ramp{tag = "icon-ramptop (NORTH)"; icon_state = "ramptop"; dir = 1},/area/space)
"g" = (/obj/structure/lattice/catwalk/indoor,/turf/simulated/open,/area/space)
"h" = (/turf/simulated/open,/area/space)
"i" = (/turf/simulated/floor/plating,/area/space)
"j" = (/turf/simulated/floor/tiled/ramp{tag = "icon-ramptop (WEST)"; icon_state = "ramptop"; dir = 8},/area/space)
"k" = (/turf/simulated/floor/tiled/ramp{tag = "icon-ramptop (EAST)"; icon_state = "ramptop"; dir = 4},/area/space)
"l" = (/obj/machinery/door/airlock/lift,/turf/simulated/floor/tiled/freezer,/area/space)
"m" = (/turf/simulated/floor/tiled/ramp,/area/space)
"n" = (/obj/machinery/door/airlock/multi_tile/glass,/turf/simulated/floor/tiled/freezer,/area/space)
"o" = (/obj/machinery/door/airlock/glass,/turf/simulated/floor/tiled/ramp,/area/space)
"p" = (/obj/structure/table/standard,/turf/simulated/floor/tiled/freezer,/area/space)
"q" = (/turf/simulated/floor/bluegrid,/area/space)
"r" = (/obj/machinery/door/airlock/glass,/turf/simulated/wall,/area/space)
"s" = (/obj/machinery/door/airlock/multi_tile/glass{tag = "icon-door_closed"; icon_state = "door_closed"; dir = 2},/turf/simulated/floor/tiled/freezer,/area/space)
"t" = (/obj/item/modular_computer/console/preset/ai,/turf/simulated/floor/tiled/freezer,/area/space)
"u" = (/obj/item/modular_computer/console/preset/research,/turf/simulated/floor/tiled/freezer,/area/space)

(1,1,1) = {"
bbbbbbbbbbbbbbbbbbbbbbbbbbbbbbbbbbbbbbbbbbbbbbbbbb
bbbbbbbbbbbbbbbbbbbbbbbbbbbbbbbbbbbbbbbbbbbbbbbbbb
bbbbbbbbbbbbbbbbbbbbbbbbbbbbbbbbbbbbbbbbbbbbbbbbbb
bbbbbbbbbbbbbbbbbbbbbbbbbbbbbbbbbbbbbbbbbbbbbbbbbb
bbbbbbbbbbbbbbbbbbbbbbbbbbbbbbbbbbbbbbbbbbbbbbbbbb
bbbbbbbbbbbbbbbbbbbbbbbbbbbbbbbbbbbbbbbbbbbbbbbbbb
bbbbbbbbbbbbbbbbbbbbbbbbbbbbbbbbbbbbbbbbbbbbbbbbbb
bbbbbbbbbbbbbbbbbbbbbbbbbbbbbbbbbbbbbbbbbbbbbbbbbb
bbbbbbbbbbbbbbbbbbbbbbbbbbbbbbbbbbbbbbbbbbbbbbbbbb
bbbbbbbbbbbbbbbbbbbbbbbbbbbbbbbbbbbbbbbbbbbbbbbbbb
bbbbbbbbbbbbbbbbbbbbbbbbbbbbbbbbbbbbbbbbbbbbbbbbbb
bbbbbbbbbbbbbbbbbbbbbbbbbbbbbbbbbbbbbbbbbbbbbbbbbb
bbbbbbbbbbbcccccccccccccccccccccccccbbbbbbbbbbbbbb
bbbbbbbbbbccccccccccccccccccccccccddcbbbbbbbbbbbbb
bbbbbbbbbccccccddddddddddddddddddcdddcbbbbbbbbbbbb
bbbbbbbbcccccccdeeeeeeeeeeeeeeeedcddddcbbbbbbbbbbb
bbbbbbbccccccccdeddddfddddfddddedcdddddcbbbbbbbbbb
bbbbbbcccccccccdedggggggggggggdedcddddddcbbbbbbbbb
bbbbbccccccccccdedghhghhhhghhgdedcdddddddcbbbbbbbb
bbbbcccccccccccdedghhghhhhghhgdedcddddddddcbbbbbbb
bbbcccccciiiiicdejggggggggggggkedcccccdcccccbbbbbb
bbccccccciiiiicdedghhgggggghhgdedcddddddddddcbbbbb
bcccccccciiiiildedghhgghhgghhgdedcdddddddddddcbbbb
bcccccccciiiiildedghhgghhgghhgdedcddddddddddddcbbb
bcccccccciiiiicdedghhgggggghhgdedcdddddddddddddcbb
bcccccccciiiiicdejggggggggggggkedcdddddddddddddcbb
bccccccccccccccdedghhghhhhghhgdedccmccccccccccccbb
bccddddddddddccdedghhghhhhghhgdedccmccciiiiiiiicbb
bccdptdddddddccdedggggggggggggdedccmccciiiiiiiicbb
bccdppddddupdccdeddddmddddmddddedckdddciiiiiiiicbb
bccdddddddppdccdeeeeeeeeeeeeeeeedckdddciiiiiiiicbb
bccddddddddddccddddddddddddddddddccmccciiiiiiiicbb
bccddddddddddcccccccccccndcccccccccmccciiiiiiiicbb
bccddddddddddcccccccccccddcccccccccmccciiiiiiiicbb
bccccccndcccccccccccccccndcccccccccoccciiiiiiiicbb
bcqqqqqqqqqqqqqqqqqqqqqqqqqqqqqqqqqqqcciiiiiiiicbb
bcqqqqqqqqqqqqqqqqqqqqqqqqqqqqqqqqqqqcccccrrccccbb
bcqqqqqqqqqqqqqqqqqqqqqqqqqqqqqqqqqqqcccccddccccbb
bcqqqaqaqaqaqaqaqaqaqaqaqaqaqaqaqaqqqcccccddccccbb
bcqqqqqqqqqqqqqqqqqqqqqqqqqqqqqqqqqqqcccccddccccbb
bcqqqaqaqaqaqaqaqaqaqaqaqaqaqaqaqaqqqdddddddccccbb
bcqqqqqqqqqqqqqqqqqqqqqqqqqqqqqqqqqqqsddddddccccbb
bcqqqaqaqaqaqaqaqaqaqaqaqaqaqaqaqaqqqccccccccccbbb
bcqqqqqqqqqqqqqqqqqqqqqqqqqqqqqqqqqqqcccccccccbbbb
bcqqqaqaqaqaqaqaqaqaqaqaqaqaqaqaqaqqqccccccccbbbbb
bcqqqqqqqqqqqqqqqqqqqqqqqqqqqqqqqqqqqcccccccbbbbbb
bcqqqqqqqqqqqqqqqqqqqqqqqqqqqqqqqqqqqccccccbbbbbbb
bcqqqqqqqqqqqqqqqqqqqqqqqqqqqqqqqqqqqcccccbbbbbbbb
bccccccccccccccccccccccccccccccccccccccccbbbbbbbbb
bbbbbbbbbbbbbbbbbbbbbbbbbbbbbbbbbbbbbbbbbbbbbbbbbb
"}
