"a" = (/turf/simulated/floor/grass,/area/space)
"b" = (/turf/unsimulated/mineral,/area/space)
"c" = (/turf/simulated/wall,/area/space)
"d" = (/turf/simulated/floor/tiled/freezer,/area/space)
"e" = (/turf/simulated/shuttle/wall,/area/space)
"f" = (/turf/simulated/floor/tiled/ramp{tag = "icon-ramptop (NORTH)"; icon_state = "ramptop"; dir = 1},/area/space)
"g" = (/obj/structure/lattice/catwalk/indoor,/turf/simulated/open,/area/space)
"h" = (/turf/simulated/open,/area/space)
"i" = (/turf/simulated/floor/plating,/area/space)
"j" = (/turf/simulated/floor/tiled/ramp{tag = "icon-ramptop (WEST)"; icon_state = "ramptop"; dir = 8},/area/space)
"k" = (/turf/simulated/floor/tiled/ramp{tag = "icon-ramptop (EAST)"; icon_state = "ramptop"; dir = 4},/area/space)
"l" = (/obj/machinery/door/airlock/lift,/turf/simulated/floor/tiled/freezer,/area/space)
"m" = (/turf/simulated/floor/tiled/ramp,/area/space)
"n" = (/obj/machinery/door/airlock/highsecurity,/turf/simulated/floor/tiled/freezer,/area/space)
"o" = (/obj/structure/closet/secure_closet/security/science,/turf/simulated/floor/tiled/freezer,/area/space)
"p" = (/obj/item/modular_computer/console/preset/security,/turf/simulated/floor/tiled/freezer,/area/space)
"q" = (/turf/simulated/floor,/area/space)
"r" = (/obj/structure/bed/chair/office/light{tag = "icon-officechair_white (EAST)"; icon_state = "officechair_white"; dir = 4},/turf/simulated/floor/tiled/freezer,/area/space)
"s" = (/obj/structure/table/glass,/turf/simulated/floor/tiled/freezer,/area/space)
"t" = (/obj/structure/bed/chair/office/light{tag = "icon-officechair_white (WEST)"; icon_state = "officechair_white"; dir = 8},/turf/simulated/floor/tiled/freezer,/area/space)
"u" = (/obj/machinery/door/airlock/glass_security,/turf/simulated/floor/tiled/freezer,/area/space)
"v" = (/turf/space,/area/space)

(1,1,1) = {"
aaaaaaaaaaaaaaaaaaaaaaaaaaaaaaaaaaaaaaaaaaaaaaaaaa
aaaaaaaaaaaaaaaaaaaaaaaaaaaaaaaaaaaaaaaaaaaaaaaaaa
aaaaaaaaaaaaaaaaaaaaaaaaaaaaaaaaaaaaaaaaaaaaaaaaaa
bbbbbbbbbbbbbbbbbbbbbbbbbbbbbbbbbbbbbbbbbbbbbbbbbb
bbbbbbbbbbbbbbbbbbbbbbbbbbbbbbbbbbbbbbbbbbbbbbbbbb
bbbbbbbbbbbbbbbbbbbbbbbbbbbbbbbbbbbbbbbbbbbbbbbbbb
bbbbbbbbbbbbbbbbbbbbbbbbbbbbbbbbbbbbbbbbbbbbbbbbbb
bbbbbbbbbbbbbbbbbbbbbbbbbbbbbbbbbbbbbbbbbbbbbbbbbb
bbbbbbbbbbbbbbbbbbbbbbbbbbbbbbbbbbbbbbbbbbbbbbbbbb
bbbbbbbbbbbbbbbbbbbbbbbbbbbbbbbbbbbbbbbbbbbbbbbbbb
bbbbbbbbbbbbbbbbbbbbbbbbbbbbbbbbbbbbbbbbbbbbbbbbbb
bbbbbbbbbbbbbbbbbbbbbbbbbbbbbbbbbbbbbbbbbbbbbbbbbb
bbbbbbbbbbbcccccccccccccccccccccccccbbbbbbbbbbbbbb
bbbbbbbbbbccccccccccccccccccccccccddcbbbbbbbbbbbbb
bbbbbbbbbccccccddddddddddddddddddcdddcbbbbbbbbbbbb
bbbbbbbbcccccccdeeeeeeeeeeeeeeeedcddddcbbbbbbbbbbb
bbbbbbbccccccccdeddddfddddfddddedcdddddcbbbbbbbbbb
bbbbbbcccccccccdedggggggggggggdedcddddddcbbbbbbbbb
bbbbbccccccccccdedghhghhhhghhgdedcdddddddcbbbbbbbb
bbbbcccccccccccdedghhghhhhghhgdedcddddddddcbbbbbbb
bbbcccccciiiiicdejggggggggggggkedcdddddddddcbbbbbb
bbccccccciiiiicdedghhgggggghhgdedcddddddddddcbbbbb
bcccccccciiiiildedghhgghhgghhgdedcdddddddddddcbbbb
bcccccccciiiiildedghhgghhgghhgdedcddddddddddddcbbb
bcccccccciiiiicdedghhgggggghhgdedcdddddddddddddcbb
bcccccccciiiiicdejggggggggggggkedcdddddddddddddcbb
bccccccccccccccdedghhghhhhghhgdedcccddccccccccccbb
bccccccccccccccdedghhghhhhghhgdedcccddciiiiiiiicbb
bccccccccccccccdedggggggggggggdedcccddciiiiiiiicbb
bccccccccccccccdeddddmddddmddddedckdddciiiiiiiicbb
bccccccccccccccdeeeeeeeeeeeeeeeedckdddciiiiiiiicbb
bccccccccccccccddddddddddddddddddcccddciiiiiiiicbb
bcccccccccccccccccccccccddccccccccccddliiiiiiiicbb
bcccccccddddddccccccccccnnccccccccccddliiiiiiiicbb
bccccdddddddddcdddoodpdcmmcccdddddddddciiiiiiiicbb
bcqdccccccccddcrsddddstcnncccdddddddddciiiiiiiicbb
bcddddddddddddcdpddddddcnncccddcccccccccccccccccbb
bcddddccccccddccccuuccccnncccddcccccccccccddccccbb
bcddddcvvvvvvvvvvvvvvvvvvvvvvvvvvvvvvcccccddccccbb
bcddddcvvvvvvvvvvvvvvvvvvvvvvvvvvvvvvcccccddccccbb
bcddddcvvvvvvvvvvvvvvvvvvvvvvvvvvvvvvdddddddccccbb
bcddddcvvvvvvvvvvvvvvvvvvvvvvvvvvvvvvdddddddccccbb
bcddddcvvvvvvvvvvvvvvvvvvvvvvvvvvvvvvccccccccccbbb
bcddddcvvvvvvvvvvvvvvvvvvvvvvvvvvvvvvcccccccccbbbb
bcddddcvvvvvvvvvvvvvvvvvvvvvvvvvvvvvvccccccccbbbbb
bcddddcvvvvvvvvvvvvvvvvvvvvvvvvvvvvvvcccccccbbbbbb
bcddddcvvvvvvvvvvvvvvvvvvvvvvvvvvvvvvccccccbbbbbbb
bcddddcvvvvvvvvvvvvvvvvvvvvvvvvvvvvvvcccccbbbbbbbb
bccccccccccccccccccccccccccccccccccccccccbbbbbbbbb
bbbbbbbbbbbbbbbbbbbbbbbbbbbbbbbbbbbbbbbbbbbbbbbbbb
"}
