"a" = (/obj/turbolift_map_holder{lift_size_x = 1},/turf/simulated/floor/plating,/area/space)
"b" = (/turf/unsimulated/mineral,/area/space)
"c" = (/turf/simulated/wall,/area/space)
"d" = (/turf/simulated/floor/tiled/freezer,/area/space)
"e" = (/turf/simulated/shuttle/wall,/area/space)
"f" = (/turf/simulated/floor/tiled/ramp{tag = "icon-ramptop (NORTH)"; icon_state = "ramptop"; dir = 1},/area/space)
"g" = (/obj/structure/lattice/catwalk/indoor,/turf/simulated/open,/area/space)
"h" = (/turf/simulated/open,/area/space)
"i" = (/turf/simulated/floor/plating,/area/space)
"j" = (/turf/simulated/floor/tiled/ramp{tag = "icon-ramptop (WEST)"; icon_state = "ramptop"; dir = 8},/area/space)
"k" = (/turf/simulated/floor/tiled/ramp{tag = "icon-ramptop (EAST)"; icon_state = "ramptop"; dir = 4},/area/space)
"l" = (/obj/machinery/door/airlock/lift,/turf/simulated/floor/tiled/freezer,/area/space)
"m" = (/turf/simulated/floor/tiled/ramp,/area/space)
"n" = (/obj/machinery/door/airlock/multi_tile/glass,/turf/simulated/floor/tiled/freezer,/area/space)
"o" = (/obj/machinery/door/airlock/glass,/turf/simulated/floor/tiled/ramp,/area/space)
"p" = (/obj/turbolift_map_holder{lift_size_x = 4; lift_size_y = 5},/turf/simulated/floor/plating,/area/space)
"q" = (/turf/simulated/floor/bluegrid,/area/space)
"r" = (/obj/machinery/door/airlock/glass,/turf/simulated/wall,/area/space)
"s" = (/obj/machinery/door/airlock/multi_tile/glass{tag = "icon-door_closed"; icon_state = "door_closed"; dir = 2},/turf/simulated/floor/tiled/freezer,/area/space)

(1,1,1) = {"
bbbbbbbbbbbbbbbbbbbbbbbbbbbbbbbbbbbbbbbbbbbbbbbbbb
bbbbbbbbbbbbbbbbbbbbbbbbbbbbbbbbbbbbbbbbbbbbbbbbbb
bbbbbbbbbbbbbbbbbbbbbbbbbbbbbbbbbbbbbbbbbbbbbbbbbb
bbbbbbbbbbbbbbbbbbbbbbbbbbbbbbbbbbbbbbbbbbbbbbbbbb
bbbbbbbbbbbbbbbbbbbbbbbbbbbbbbbbbbbbbbbbbbbbbbbbbb
bbbbbbbbbbbbbbbbbbbbbbbbbbbbbbbbbbbbbbbbbbbbbbbbbb
bbbbbbbbbbbbbbbbbbbbbbbbbbbbbbbbbbbbbbbbbbbbbbbbbb
bbbbbbbbbbbbbbbbbbbbbbbbbbbbbbbbbbbbbbbbbbbbbbbbbb
bbbbbbbbbbbbbbbbbbbbbbbbbbbbbbbbbbbbbbbbbbbbbbbbbb
bbbbbbbbbbbbbbbbbbbbbbbbbbbbbbbbbbbbbbbbbbbbbbbbbb
bbbbbbbbbbbbbbbbbbbbbbbbbbbbbbbbbbbbbbbbbbbbbbbbbb
bbbbbbbbbbbbbbbbbbbbbbbbbbbbbbbbbbbbbbbbbbbbbbbbbb
bbbbbbbbbbbcccccccccccccccccccccccccbbbbbbbbbbbbbb
bbbbbbbbbbccccccccccccccccccccccccddcbbbbbbbbbbbbb
bbbbbbbbbccccccddddddddddddddddddcdddcbbbbbbbbbbbb
bbbbbbbbcccccccdeeeeeeeeeeeeeeeedcddddcbbbbbbbbbbb
bbbbbbbccccccccdeddddfddddfddddedcdddddcbbbbbbbbbb
bbbbbbcccccccccdedggggggggggggdedcddddddcbbbbbbbbb
bbbbbccccccccccdedghhghhhhghhgdedcdddddddcbbbbbbbb
bbbbcccccccccccdedghhghhhhghhgdedcddddddddcbbbbbbb
bbbcccccciiiiicdejggggggggggggkedcccccdcccccbbbbbb
bbccccccciiiiicdedghhgggggghhgdedcddddddddddcbbbbb
bcccccccciiiiildedghhgghhgghhgdedcdddddddddddcbbbb
bcccccccciiiiildedghhgghhgghhgdedcddddddddddddcbbb
bcccccccciaiiicdedghhgggggghhgdedcdddddddddddddcbb
bcccccccciiiiicdejggggggggggggkedcdddddddddddddcbb
bccccccccccccccdedghhghhhhghhgdedccmccccccccccccbb
bccddddddddddccdedghhghhhhghhgdedccmccciiiiiiiicbb
bccddddddddddccdedggggggggggggdedccmccciiiiiiiicbb
bccddddddddddccdeddddmddddmddddedckdddciiiiiiiicbb
bccddddddddddccdeeeeeeeeeeeeeeeedckdddciiiiiiiicbb
bccddddddddddccddddddddddddddddddccmccciiiiiiiicbb
bccddddddddddcccccccccccndcccccccccmccciiiiiiiicbb
bccddddddddddcccccccccccddcccccccccmccciiiiiiiicbb
bccccccndcccccccccccccccndcccccccccocccipiiiiiicbb
bcqqqqqqqqqqqqqqqqqqqqqqqqqqqqqqqqqqqcciiiiiiiicbb
bcqqqqqqqqqqqqqqqqqqqqqqqqqqqqqqqqqqqcccccrrccccbb
bcqqqqqqqqqqqqqqqqqqqqqqqqqqqqqqqqqqqcccccddccccbb
bcqqqqqqqqqqqqqqqqqqqqqqqqqqqqqqqqqqqcccccddccccbb
bcqqqqqqqqqqqqqqqqqqqqqqqqqqqqqqqqqqqcccccddccccbb
bcqqqqqqqqqqqqqqqqqqqqqqqqqqqqqqqqqqqdddddddccccbb
bcqqqqqqqqqqqqqqqqqqqqqqqqqqqqqqqqqqqsddddddccccbb
bcqqqqqqqqqqqqqqqqqqqqqqqqqqqqqqqqqqqccccccccccbbb
bcqqqqqqqqqqqqqqqqqqqqqqqqqqqqqqqqqqqcccccccccbbbb
bcqqqqqqqqqqqqqqqqqqqqqqqqqqqqqqqqqqqccccccccbbbbb
bcqqqqqqqqqqqqqqqqqqqqqqqqqqqqqqqqqqqcccccccbbbbbb
bcqqqqqqqqqqqqqqqqqqqqqqqqqqqqqqqqqqqccccccbbbbbbb
bcqqqqqqqqqqqqqqqqqqqqqqqqqqqqqqqqqqqcccccbbbbbbbb
bccccccccccccccccccccccccccccccccccccccccbbbbbbbbb
bbbbbbbbbbbbbbbbbbbbbbbbbbbbbbbbbbbbbbbbbbbbbbbbbb
"}
