"a" = (/turf/simulated/open,/area/space)
"b" = (/obj/structure/grille,/obj/structure/window/reinforced/full,/turf/simulated/floor,/area/space)
"c" = (/turf/simulated/wall,/area/space)
"d" = (/obj/structure/window/reinforced/full,/obj/structure/grille,/turf/simulated/floor,/area/space)
"e" = (/turf/simulated/floor/tiled/freezer,/area/space)
"f" = (/turf/simulated/shuttle/wall,/area/space)
"g" = (/turf/simulated/floor/tiled/ramp{tag = "icon-ramptop (NORTH)"; icon_state = "ramptop"; dir = 1},/area/space)
"h" = (/obj/structure/lattice/catwalk/indoor,/turf/simulated/open,/area/space)
"i" = (/turf/simulated/floor/plating,/area/space)
"j" = (/turf/simulated/floor/tiled/ramp{tag = "icon-ramptop (WEST)"; icon_state = "ramptop"; dir = 8},/area/space)
"k" = (/turf/simulated/floor/tiled/ramp{tag = "icon-ramptop (EAST)"; icon_state = "ramptop"; dir = 4},/area/space)
"l" = (/obj/machinery/door/airlock/lift,/turf/simulated/floor/tiled/freezer,/area/space)
"m" = (/turf/simulated/floor/tiled/ramp,/area/space)

(1,1,1) = {"
aaaaaaaaaaaaaaaaaaaaaaaaaaaaaaaaaaaaaaaaaaaaaaaaaa
aaaaaaaaaaaaaaaaaaaaaaaaaaaaaaaaaaaaaaaaaaaaaaaaaa
aaaaaaaaaaaaaaaaaaaaaaaaaaaaaaaaaaaaaaaaaaaaaaaaaa
aaaaaaaaaaaaaaaaaaaaaaaaaaaaaaaaaaaaaaaaaaaaaaaaaa
aaaaaaaaaaaaaaaaaaaaaaaaaaaaaaaaaaaaaaaaaaaaaaaaaa
aaaaaaaaaaaaaaaaaaaaaaaaaaaaaaaaaaaaaaaaaaaaaaaaaa
aaaaaaaaaaaaaaaaaaaaaaaaaaaaaaaaaaaaaaaaaaaaaaaaaa
aaaaaaaaaaaaaaaaaaaaaaaaaaaaaaaaaaaaaaaaaaaaaaaaaa
aaaaaaaaaaaaaaaaaaaaaaaaaaaaaaaaaaaaaaaaaaaaaaaaaa
aaaaaaaaaaaaaaaaaaaaaaaaaaaaaaaaaaaaaaaaaaaaaaaaaa
aaaaaaaaaaaaaaaaaaaaaaaaaaaaaaaaaaaaaaaaaaaaaaaaaa
aaaaaaaaaaaaaaaaaaaaaaaaaaaaaaaaaaaaaaaaaaaaaaaaaa
aaaaaaaaaaabbcccccccccccccccccccccddaaaaaaaaaaaaaa
aaaaaaaaaabeeecccccccccccccccccccceedaaaaaaaaaaaaa
aaaaaaaaabeeeeceeeeeeeeeeeeeeeeeeceeedaaaaaaaaaaaa
aaaaaaaabeeeeeceffffffffffffffffeceeeedaaaaaaaaaaa
aaaaaaabeeeeeecefeeeegeeeegeeeefeceeeeedaaaaaaaaaa
aaaaaabeeeeeeecefehhhhhhhhhhhhefeceeeeeedaaaaaaaaa
aaaaabeeeeeeeecefehaahaaaahaahefeceeeeeeedaaaaaaaa
aaaabeeecccccccefehaahaaaahaahefeceeeeeeeedaaaaaaa
aaabeeeeciiiiicefjhhhhhhhhhhhhkfeceeeeeeeeedaaaaaa
aabeeeeeciaaaicefehaahhhhhhaahefeceeeeeeeeeedaaaaa
abeeeeeeciaaailefehaahhaahhaahefeceeeeeeeeeeedaaaa
abeeeeeeciaaailefehaahhaahhaahefeceeeeeeeeeeeedaaa
aceeeeeeciaaaicefehaahhhhhhaahefeceeeeeeeeeeeeedaa
aceeeeeeciiiiicefjhhhhhhhhhhhhkfeceeeeeeeeeeeeedaa
accccecccccccccefehaahaaaahaahefeccmmmcccceeccccaa
aceeeeeceeeeeecefehaahaaaahaahefecceeeciiiiiiiicaa
acecceeceeeeeecefehhhhhhhhhhhhefecceeeciaaaaaaicaa
aceeceeceeeeeecefeeeemeeeemeeeefecceeeciaaaaaaicaa
aceeceeeeeeeeeceffffffffffffffffecceeeciaaaaaaicaa
acceceeceeeeeeceeeeeeeeeeeeeeeeeecceeeciaaaaaaicaa
acceceeccccccccccccccccceeccccccccceeeciaaaaaaicaa
aceeeeeeeeeeeeeeeeeeeeeeeeeeecccccceeeciaaaaaaicaa
aceeeeeeeeeeeeeeeeeeeeeeeeeeeeeeeeeeeeciaaaaaaicaa
acccccccceccccecccccccecceeeeeeeeeeeeeciiiiiiiicaa
aceeeeeececeeeeeeeeeeeeeeceeecccccceeccccceeccccaa
aceeeeeececeeeeeeeeeeeeeeeceeceeeeceeeeeeceeceecaa
aceeeeeeeeceeeeeeeeeeeeeeeceeeeeeeceeeeeeceeceecaa
aceeeeeececeeeeeeeeeeeeeecceecccccceeccccceeccccaa
aceeeeeececcccccceccccccccceeceeeeceeceeeeeeeeedaa
acccccccceceeeeeeeeeeeeceeceeceeeeceeceeeeeeeeedaa
aceeeeeececeeeeeeeeeeeeceeceeceeeeceeceeeeeeeedaaa
aceeeeeececeeeeeeeeeeeeceeceeceeeeceeeeeeeeeedaaaa
aceeeeeeeeceeeeeeeeeeeeceeceeeeeeeceeeeeeeeedaaaaa
aceeeeeececcccccccceccccecceeccccccecceeeeedaaaaaa
aceeeeeeceeeeeeeeeeeeeeeeeeeeeeceeeeeceeeedaaaaaaa
aceeeeeeceeeeeeeeeeeeeeeeeeeeeeceeeeeceeedaaaaaaaa
acccccccccccccccccccccccccccccccccccccdddaaaaaaaaa
aaaaaaaaaaaaaaaaaaaaaaaaaaaaaaaaaaaaaaaaaaaaaaaaaa
"}
