"a" = (/turf/simulated/open,/area/space)
"b" = (/turf/simulated/wall,/area/space)
"c" = (/obj/structure/window/reinforced/full,/obj/structure/grille,/turf/simulated/floor,/area/space)
"d" = (/turf/simulated/floor/tiled/freezer,/area/space)
"e" = (/turf/simulated/shuttle/wall,/area/space)
"f" = (/turf/simulated/floor/tiled/ramp{tag = "icon-ramptop (NORTH)"; icon_state = "ramptop"; dir = 1},/area/space)
"g" = (/obj/structure/lattice/catwalk/indoor,/turf/simulated/open,/area/space)
"h" = (/obj/structure/grille,/obj/structure/window/reinforced/full,/turf/simulated/floor,/area/space)
"i" = (/turf/simulated/floor/plating,/area/space)
"j" = (/turf/simulated/floor/tiled/ramp{tag = "icon-ramptop (WEST)"; icon_state = "ramptop"; dir = 8},/area/space)
"k" = (/turf/simulated/floor/tiled/ramp{tag = "icon-ramptop (EAST)"; icon_state = "ramptop"; dir = 4},/area/space)
"l" = (/obj/machinery/door/airlock/lift,/turf/simulated/floor/tiled/freezer,/area/space)
"m" = (/obj/machinery/door/airlock/glass_science,/turf/simulated/floor/tiled/freezer,/area/space)
"n" = (/turf/simulated/floor/tiled/ramp,/area/space)
"o" = (/turf/simulated/floor/tiled/ramp/bottom,/area/space)
"p" = (/obj/machinery/door/airlock/glass,/turf/simulated/floor/tiled/freezer,/area/space)
"q" = (/obj/machinery/door/airlock/multi_tile/glass,/turf/simulated/floor/tiled/freezer,/area/space)
"r" = (/turf/simulated/floor/tiled/ramp/bottom{icon_state = "rampbot"; dir = 8},/area/space)
"s" = (/obj/machinery/door/airlock/highsecurity,/turf/simulated/floor/tiled/freezer,/area/space)
"t" = (/turf/simulated/floor/tiled/ramp/bottom{icon_state = "rampbot"; dir = 1},/area/space)
"u" = (/obj/machinery/door/airlock{_wifi_id = "eastBathroomLock"; name = "Restroom"},/turf/simulated/floor/tiled/freezer,/area/space)
"v" = (/obj/machinery/button/toggle/door{_door_functions = 4; _wifi_id = "eastBathroomLock"; id = null; pixel_y = 24},/turf/simulated/floor/tiled/freezer,/area/space)
"w" = (/obj/structure/mirror{pixel_y = 32},/obj/structure/sink{pixel_y = 16},/turf/simulated/floor/tiled/freezer,/area/space)
"x" = (/obj/structure/closet/secure_closet/guncabinet{name = "secure gun locker"},/obj/item/weapon/gun/projectile/automatic/c20r,/obj/item/weapon/gun/projectile/automatic/c20r,/turf/simulated/floor/tiled/freezer,/area/space)
"y" = (/obj/machinery/door/airlock{name = "Unit 1"},/turf/simulated/floor/tiled/freezer,/area/space)
"z" = (/obj/structure/toilet{dir = 1},/turf/simulated/floor/tiled/freezer,/area/space)
"A" = (/turf/simulated/wall{can_open = 1},/area/space)
"B" = (/obj/item/ammo_magazine/a10mm,/obj/item/ammo_magazine/a10mm,/obj/item/ammo_magazine/a10mm,/obj/structure/closet/secure_closet/guncabinet{name = "10mm ammo cabinet"},/turf/simulated/floor/tiled/freezer,/area/space)
"C" = (/obj/machinery/door/airlock/glass_engineering{name = "Storage"; req_access = list(); req_one_access = list(11,24)},/turf/simulated/floor/tiled/freezer,/area/space)
"D" = (/obj/machinery/door/airlock{name = "Unit 2"},/turf/simulated/floor/tiled/freezer,/area/space)

(1,1,1) = {"
aaaaaaaaaaaaaaaaaaaaaaaaaaaaaaaaaaaaaaaaaaaaaaaaaa
aaaaaaaaaaaaaaaaaaaaaaaaaaaaaaaaaaaaaaaaaaaaaaaaaa
aaaaaaaaaaaaaaaaaaaaaaaaaaaaaaaaaaaaaaaaaaaaaaaaaa
aaaaaaaaaaaaaaaaaaaaaaaaaaaaaaaaaaaaaaaaaaaaaaaaaa
aaaaaaaaaaaaaaaaaaaaaaaaaaaaaaaaaaaaaaaaaaaaaaaaaa
aaaaaaaaaaaaaaaaaaaaaaaaaaaaaaaaaaaaaaaaaaaaaaaaaa
aaaaaaaaaaaaaaaaaaaaaaaaaaaaaaaaaaaaaaaaaaaaaaaaaa
aaaaaaaaaaaaaaaaaaaaaaaaaaaaaaaaaaaaaaaaaaaaaaaaaa
aaaaaaaaaaaaaaaaaaaaaaaaaaaaaaaaaaaaaaaaaaaaaaaaaa
aaaaaaaaaaaaaaaaaaaaaaaaaaaaaaaaaaaaaaaaaaaaaaaaaa
aaaaaaaaaaaaaaaaaaaaaaaaaaaaaaaaaaaaaaaaaaaaaaaaaa
aaaaaaaaaaaaaaaaaaaaaaaaaaaaaaaaaaaaaaaaaaaaaaaaaa
aaaaaaaaaaabbbbbbbbbbbbbbbbbbbbbbbccaaaaaaaaaaaaaa
aaaaaaaaaabdddbbbbbbbbbbbbbbbbbbbbddcaaaaaaaaaaaaa
aaaaaaaaabddddbddddddddddddddddddbdddcaaaaaaaaaaaa
aaaaaaaabdddddbdeeeeeeeeeeeeeeeedbddddcaaaaaaaaaaa
aaaaaaabddddddbdeddddfddddfddddedbdddddcaaaaaaaaaa
aaaaaabbddddddbdedggggggggggggdedbddddddcaaaaaaaaa
aaaaabbbddddddbdedgaagaaaagaagdedbdddddddcaaaaaaaa
aaaahdddbbbbbbbdedgaagaaaagaagdedbddddddddcaaaaaaa
aaahddddbiiiiibdejggggggggggggkedbdddddddddcaaaaaa
aahdddddbiaaaibdedgaaggggggaagdedbddddddddddcaaaaa
ahddddddbiaaaildedgaaggaaggaagdedbdddddddddddcaaaa
ahddddddbiaaaildedgaaggaaggaagdedbddddddddddddcaaa
abddddddbiaaaibdedgaaggggggaagdedbdddddddddddddcaa
abddddddbiiiiibdejggggggggggggkedbdddddddddddddcaa
abbbbmbbbbbbbbbdedgaagaaaagaagdedbbnnnbbbboobbbbaa
abdddddbddddddbdedgaagaaaagaagdedbbdddbiiiiiiiibaa
abpbbddbddddddbdedggggggggggggdedbbdddbiaaaaaaibaa
abddbddbddddddbdeddddnddddnddddedbbdddbiaaaaaaibaa
abddbddmddddddbdeeeeeeeeeeeeeeeedbbdddbiaaaaaaibaa
abbdbddbddddddbddddddddddddddddddbbdddbiaaaaaaibaa
abbpbddbbbbbbbbbbbbbbbqdbbbbbbbbbbbdddbiaaaaaaibaa
abddddddddrdddddddddddddrdddddbbbbbdddbiaaaaaaibaa
abddddddddrdddddddddddddrdddddddrssdddbiaaaaaaibaa
abbbbbbbbdbbbbmbbbbbbbmbbdddddddrssdddbiiiiiiiibaa
abddddddbdbddddddddddddddbdddbbbbbbddbbbbbttbbbbaa
abddddddbdbdddddddddddddddboobddddbdduvwdbddbdxbaa
abddddddmdbdddddddddddddddbddyddddbddbddzbddAdBbaa
abddddddbdbddddddddddddddbbddbbbbbbddbbbbbddbbbbaa
abddddddbdbbbbbbbdbbbbbbbbbddbddddbddbdddddddddcaa
abbbbbbbbdbddddddddddddbddbddbddddbddbdddddddddcaa
abddddddbdbddddddddddddbddbddbddddbddbddddddddcaaa
abddddddbdbddddddddddddbddbddbddddbddrdddddddcaaaa
abddddddmdbddddddddddddbddbddCddddbddrddddddcaaaaa
abddddddbdbbbbbbbbbmbbbbDbbddbbbbbbpbbdddddcaaaaaa
abddddddbdrdddddddddddddddrddddbdddddbddddcaaaaaaa
abddddddbdrdddddddddddddddrddddbdddddbdddcaaaaaaaa
abbbbbbbbbbbbbbbbbbbbbbbbbbbbbbbbbbbbbcccaaaaaaaaa
aaaaaaaaaaaaaaaaaaaaaaaaaaaaaaaaaaaaaaaaaaaaaaaaaa
"}
